###################
#E          #     #
#  ##########  #  #
#           D  #  #
##########  #  ####
#         T #  #  #
#  #############  #
# S        X      #
#  #  ####  #  #  #
#U #  #     #  C  #
####  #  #  #  #  #
#    V#  #  #  #WF#
###################